+---+---+---+---+---+
|               |   |
+   +---+   +---+   +
|   |           |   |
+   +---+---+   +   +
|       |   |       |
+---+   +   +   +---+
|   |       |       |
+   +   +---+   +   +
|               |   |
+---+---+---+---+---+